11111111111111111111
1P0001D1000000C00001
100000100000000D0001
1000000000E000000001
10S00000000000000001
1000D0000000000D0001
10000000000000000001
11111111111111111111